
NO 		textures/greystone.xpm
SO		textures/greystone.xpm
WE		textures/greystone.xpm
EA		textures/greystone.xpm
F			184,113,55
C			184,113,55

11111111111111
10000000000001
10000000000001
100E0000000001
11111111111111
