
NO textures/wood.xpm
SO textures/wood.xpm
WE textures/wood.xpm
EA textures/wood.xpm

F 82, 117, 82
C 200, 240, 250

111
1011
10011111111
10000000001
10001111001
1N001  1001
10000111111
100001111
10000000111111
10000000000001
10111101100001
 1000001100001
  100001101111
  110111101
  1101  101
  110111101
 1000001101
 1001000001
 1001100001
 1100001111
 10011111
 1001
10001
10011111111
10000000001
10001111001
10001  1001
10000111111
100001111
10000000111111
10000000000001
10111101100001
 1000001100001
  100001101111
  110111101
  1101  101
  110111101
 1000001101
 1001000001
 1001100001
 1100001111
 11111111
