C 172,21,237
F 		204,237	,57

NO 				./textures/mossy.xpm
			SO ./textures/mossy.xpm
WE ./textures/mossy.xpm
EA ./textures/mossy.xpm

1111111111
1000000001
1111000001
100000N001
1000001001
1010001011
1000010101
1111111111
							
1111111111
1000000001
1111000001
1000000001
1000001001
1010001011
1000010101
1111111111